%%%%%%%%%%%%%%%%%%%%%%%%%%%%%%%%%%%%%%%%%%%%%%%%%%%%%%%%%%%%%%%%%%%%%%%%%%%%%%%%%%%%%%%%%%%%%%%%%%%%
%%%%%%%%%%%%%%%%%%%%%%%%%%%%%%%%%%%%%%%%%%%%%%%%%%%%%%%%%%%%%%%%%%%%%%%%%%%%%%%%%%%%%%%%%%%%%%%%%%%%
%%                                                                                                %%
%%                                                                                                %%
%%                                                                                                %%
%%                                                                                                %%
%%                                                                                                %%
%%                                                                                                %%
%%                                                                                                %%
%%                                                                                                %%
%%                                                                                                %%
%%                                                                                                %%
%%                                                                                                %%
%%                                                                                                %%
%%                                                                                                %%
%%                                                                                                %%
%%                                                                                                %%
%%                                                                                                %%
%%                                                                                                %%
%%                                                                                                %%
%%                                    %%%%%%%%%%%%%%%%                          *                 %%
%%               @                      %%%%%%%%%%%%%%%%                                          %%
%%                                 %%%%%%%%%%%%%%%%                                               %%
%%                                     %%%%%%%%%%%%%%%%                                           %%
%%                                       %%%%%%%%%%%%%%%%                                         %%
%%                                   %%%%%%%%%%%%%%%%                                             %%
%%                                                                                                %%
%%                                                                                                %%
%%                                                                                                %%
%%                                                                                                %%
%%                                                                                                %%
%%                                                                                                %%
%%                                                                                                %%
%%                                                                                                %%
%%                                                                                                %%
%%                                                                                                %%
%%                                                                                                %%
%%                                                                                                %%
%%                                                                                                %%
%%                                                                                                %%
%%                                                                                                %%
%%                                                                                                %%
%%                                                                                                %%
%%                                                                                                %%
%%%%%%%%%%%%%%%%%%%%%%%%%%%%%%%%%%%%%%%%%%%%%%%%%%%%%%%%%%%%%%%%%%%%%%%%%%%%%%%%%%%%%%%%%%%%%%%%%%%%
%%%%%%%%%%%%%%%%%%%%%%%%%%%%%%%%%%%%%%%%%%%%%%%%%%%%%%%%%%%%%%%%%%%%%%%%%%%%%%%%%%%%%%%%%%%%%%%%%%%%